가부간	문장부사/접속부사/결과
게다가	문장부사/접속부사/첨가
결국	문장부사/접속부사/결과
고로	문장부사/접속부사/이유
그나저나	문장부사/접속부사/전환
그래	문장부사/접속부사/순접
그래도	문장부사/접속부사/대조
그래서	문장부사/접속부사/연접
그래야	문장부사/접속부사/조건
그래저래	문장부사/접속부사/이유
그러게	문장부사/접속부사/이유
그러나	문장부사/접속부사/대조
그러나저러나	문장부사/접속부사/전환
그러니	문장부사/접속부사/순접
그러니까	문장부사/접속부사/연접
그러니만치	문장부사/접속부사/순접
그러니만큼	문장부사/접속부사/순접
그러다	문장부사/접속부사/결과
그러다가	문장부사/접속부사/결과
그러면	문장부사/접속부사/조건
그러면서	문장부사/접속부사/순접
그러므로	문장부사/접속부사/인과
그러자	문장부사/접속부사/순접
그러한즉	문장부사/접속부사/순접
그런고로	문장부사/접속부사/인과
그런데	문장부사/접속부사/전환
그런데도	문장부사/접속부사/양보
그런만큼	문장부사/접속부사/순접
그런즉	문장부사/접속부사/순접
그럼	문장부사/접속부사/조건
그럼에도	문장부사/접속부사/양보
그렇다고	문장부사/접속부사/역접
그렇지마는	문장부사/접속부사/역접
그렇지만	문장부사/접속부사/역접
그리고	문장부사/접속부사/연접
그리하여	문장부사/접속부사/순접
근데	문장부사/접속부사/전환
기왕지사	문장부사/접속부사/조건
나아가서	문장부사/접속부사/첨가
내지	문장부사/접속부사/연접
단지	문장부사/접속부사/첨가
대체	문장부사/접속부사/의문강조
더구나	문장부사/접속부사/첨가
더군다나	문장부사/접속부사/첨가
더더구나	문장부사/접속부사/첨가
더더군다나	문장부사/접속부사/첨가
더욱이	문장부사/접속부사/첨가
더욱이나	문장부사/접속부사/첨가
도리어	문장부사/접속부사/역접
따라서	문장부사/접속부사/연접
때로	문장부사/접속부사/첨가
또는	문장부사/접속부사/이접
또한	문장부사/접속부사/연접
마침내	문장부사/접속부사/결과
말하자면	문장부사/접속부사/환언
무론	문장부사/접속부사/연접
물론	문장부사/접속부사/연접
세칭	문장부사/접속부사/환언
소위	문장부사/접속부사/환언
아니나 다를까	문장부사/접속부사/환언
아닌게아니라	문장부사/접속부사/환언
아무튼	문장부사/접속부사/전환
아무튼지	문장부사/접속부사/환언
암튼	문장부사/접속부사/전환
어떻든	문장부사/접속부사/전환
어떻든지	문장부사/접속부사/전환
어쨌건	문장부사/접속부사/전환
어쨌든	문장부사/접속부사/전환
어쨌든지	문장부사/접속부사/전환
언필칭	문장부사/접속부사/기타
여하간	문장부사/접속부사/전환
여하튼	문장부사/접속부사/전환
여하튼지	문장부사/접속부사/전환
역시	문장부사/접속부사/연접
예컨대	문장부사/접속부사/예시
오히려	문장부사/접속부사/대조
왜냐면	문장부사/접속부사/이유
왜냐하면	문장부사/접속부사/이유
외려	문장부사/접속부사/역접
요는	문장부사/접속부사/요약
요컨대	문장부사/접속부사/요약
이래저래	문장부사/접속부사/이유
이러나저러나	문장부사/접속부사/전환
이러다	문장부사/접속부사/기타
이러다가	문장부사/접속부사/결과
이러므로	문장부사/접속부사/인과
이럼	문장부사/접속부사/조건
이른바	문장부사/접속부사/환언
이를테면	문장부사/접속부사/예시
이리하여	문장부사/접속부사/결과
일단	문장부사/접속부사/시간
일테면	문장부사/접속부사/예시
자칫하면	문장부사/접속부사/가정
좌우간	문장부사/접속부사/전환
즉	문장부사/접속부사/환언
차라리	문장부사/접속부사/양보
하기는	문장부사/접속부사/양보
하기야	문장부사/접속부사/양보
하긴	문장부사/접속부사/양보
하나	문장부사/접속부사/대조
하마터면	문장부사/접속부사/추측
하물며	문장부사/접속부사/첨가
하여간	문장부사/접속부사/전환
하여간에	문장부사/접속부사/전환
하여튼	문장부사/접속부사/전환
하여튼지	문장부사/접속부사/전환
하지마는	문장부사/접속부사/대조
하지만	문장부사/접속부사/대조
한데	문장부사/접속부사/전환
한편	문장부사/접속부사/전환
항차	문장부사/접속부 사/대조
혹은	문장부사/접속부사/이접
황차	문장부사/접속부사/첨가